 ##   #
  # P #
# #   #
  #   #
      #
#######